# ############
#            #
#####  #######
#        #   #
#  #######   #
#            O
#######  #####
      #  #
      ####