# #############
#             #
############# #
#             #
#  ############
#             O
#######  #  ###
#######  #  ###   
###############